!!ATOK_TANGO_TEXT_HEADER_1
あかのそしき	赤の組織	固有一般
あにきとこぶん	アニキとコブン	固有一般
あぶらめしや	油飯屋	固有一般
あめもりくどう	雨森久遠	固有一般
あらさーらんくたい	アラサーランク帯	固有一般
ありすとろべりー	アリストロベリー	固有一般
あれくしーどふぁみりあ	AlleXceed Familia	固有一般
あんさついっか	暗殺一家	固有一般
いーりす	i's	固有一般
いたずらぐみ	痛面組	固有一般
いっそういっせい	一槍一星	固有一般
いでぃおす	Idios	固有一般
ゔぁっくす	VACHSS	固有一般
ゔぁるつ	VΔLZ	固有一般
ういすぴーどーなっつ	ういすぴ～ど～なっつ	固有一般
ういにんぐらん	ういにんぐらん	固有一般
ういにんぐらん	ういにんグらん	固有一般
ゔぉいず	VOIZ	固有一般
うんちきょう	うんち教	固有一般
えくすげーまーず	EXゲーマーズ	固有一般
えすえふぐみ	SF組	固有一般
えでんぐみ	エデン組	固有一般
えばーぐりーんなーど	evergreen nerd	固有一般
えらーず	ERRors	固有一般
えんじょうりゅうせいぐん	炎上流星群	固有一般
おーてぃーえぬぐみ	OTN組	固有一般
おとこぐみ	漢組	固有一般
おなえどしぐみ	おなえどし組	固有一般
おりえんす	Oriens	固有一般
おりこう	おりコウ	固有一般
おりひめぼし	織姫星	固有一般
かいさんぎぐ	解散GIG	固有一般
かえでとみと	楓と美兎	固有一般
がちくずのうか	ガチ屑農家	固有一般
がっかい	ガッ灰	固有一般
かなえよう	叶え葉	固有一般
きらきらおんせん	きらきら温泉	固有一般
きらんご	きらンゴ	固有一般
きんぎんどうぽん	金銀銅ポン	固有一般
ぐりーんるーじゅ	グリーンルージュ	固有一般
くれっしぇんど	cresc.	固有一般
くれないのらいへんばっは	紅のライヘンバッハ	固有一般
くろしっく	Crossick	固有一般
くろのひまわり	黒ノ火廻	固有一般
くろのわーる	ChroNoiR	固有一般
げっかびじん	月華美人	固有一般
こうはくあほがっせん	紅白アホ合戦	固有一般
こくむちょう	黒夢町	固有一般
ここふれわんわん	ここフレわんわん	固有一般
ござんぼ	ござンボ	固有一般
こじらせはらすめんと	こじらせ★ハラスメント	固有一般
さいこぐみ	サイコ組	固有一般
さんしゃめんだん	三者面団	固有一般
さんふらわーがーでん	花園快晴	固有一般
しーず	SEEDs	固有一般
しーりー	SiiRii	固有一般
じぇーえすぐみ	JS組	固有一般
じぇーけーえる	JKL	固有一般
じぇーけーぐみ	JK組	固有一般
しぶやだいがく	渋谷大ガク	固有一般
じょしこうはなばたけ	女子校花畑	固有一般
しりんそう	シリンソウ	固有一般
じるじゅえ	THE lejouet	固有一般
しるばーでびるず	SilverDevilS	固有一般
しんやさんけつあーるけーえす	深夜三傑RKS	固有一般
すけべぐみ	SKB部	固有一般
すしぐみ	SC組	固有一般
すとろべる	ストロベル	固有一般
すのうぽっぷ	SNOWPOP	固有一般
すのーべる	スノーベル	固有一般
すめしぐみ	SMC組	固有一般
すりーえすけーえむ	3SKM	固有一般
せれいねえんげきどうこうかい	世怜音演劇同好会	固有一般
せれじょこうとうぶぐみ	セレじょ高等部組	固有一般
そうおんしまい	騒音姉妹	固有一般
そでなしぶらっくりりぃ	袖無しブラックリリィ	固有一般
たかじょう	鷹匠	固有一般
だぶるすりーぶ	ダブルスリーブ	固有一般
だれぱんだ	ダレパンダ	固有一般
たんていとじょしゅ	探偵と助手	固有一般
ちちげやま	乳毛山	固有一般
ちちやま	乳山	固有一般
ちゅーりっぷぐみ	チューリップ組	固有一般
でぃーのいし	Dの石	固有一般
でぃてぃか	Dytica	固有一般
でびりおん	でびリオン	固有一般
でろろぎ	デロロギ	固有一般
でろんぼ	でろンボ	固有一般
でんおんぶ	電音部	固有一般
とぅいんくる	Twinkle	固有一般
とうえる	刀える	固有一般
とうかざ	刀かざ	固有一般
とうりり	刀リリ	固有一般
どうわぐみ	童話組	固有一般
とがびと	†咎人†	固有一般
どくずほんしゃ	ド葛本社	固有一般
どくずほんしゃおるた	ド葛本社オルタ	固有一般
とらいと	トライト	固有一般
どらひま	ドラひま	固有一般
とりがー	トリガー	固有一般
とりにてぃ	▽▲TRiNITY▲▽	固有一般
やおうこく	夜王国	固有一般
なぞめん	NZMN	固有一般
にじいろきゃんでぃー	にじいろきゃんD→☆	固有一般
きょうけんず	狂犬ズ	固有一般
にじさんじますこっつ	にじさんじマスコッツ	固有一般
にじさんじれじすたんす	にじさんじレジスタンス	固有一般
にじさんじれじすたんすかぶ	にじさんじレジスタンス(株)	固有一般
にじれじ	にじレジ	固有一般
にじれじかぶ	にじレジ(株)	固有一般
のるにす	Nornis	固有一般
はっぴーとりがー	ハッピートリガー	固有一般
はんごろし	はンゴろし	固有一般
びーじーくらぶ	BGクラブ	固有一般
ぴゅあぱれっと	pure♡palet	固有一般
ふけいざい	フ景罪	固有一般
ぷちふるーる	petit fleurs	固有一般
ぷりずむりりっく	ぷりずむりりっく！	固有一般
へくせんしゅす	Hexenschuß彡	固有一般
べにずわいがに	紅ズワイガニ	固有一般
へぶんがーるず	ヘブンガールズ	固有一般
ぽさんけ	ぽさんけ	固有一般
ほしとたんてい	ホシと探偵	固有一般
ぼるたくしょん	VOLTACTION	固有一般
ほんまのくずや	本間ノ葛也	固有一般
まいもとりきいち	舞元力一	固有一般
まぶてん	魔武天	固有一般
みれろあ	みれロア	固有一般
むーんらいとぶろっさむ	月下の桜	固有一般
めいふ	メイフ	固有一般
めしぐみ	MC組	固有一般
めちゃつえー	MECHATU-A	固有一般
めっしゃーず	メッシャーズ	固有一般
もほすず	モほすず	固有一般
もりえだ	森枝	固有一般
ゆめほしけ	夢星家	固有一般
ようきゃーず	陽キャーズ	固有一般
らくよう	楽陽	固有一般
らなんきゅらす	Ranunculus	固有一般
りぜあん	リゼアン	固有一般
りぜるる	リゼるる	固有一般
りりーくらうん	Lilly Crown	固有一般
りりかざ	リリかざ	固有一般
りりり	RRR	固有一般
りんかえだぶる	りんかえW	固有一般
るーざーきんぐす	ルーザーキングス	固有一般
るじゅえ	le jouet	固有一般
れいんどろっぷす	Rain Drops	固有一般
れべるえっくす	LvEx	固有一般
ろりぐみ	ロリ組	固有一般
んごかいな	ンゴ灰那	固有一般
