!!ATOK_TANGO_TEXT_HEADER_1
つきのみと	月ノ美兎	固有人他
える	える	固有人他
ひぐちかえで	樋口楓	固有人他
しずかりん	静凛	固有人他
しぶやはじめ	渋谷ハジメ	固有人他
すずやあき	鈴谷アキ	固有人他
もいら	モイラ	固有人他
ゆうきちひろ	勇気ちひろ	固有人他
しぶやおわり	渋谷オワリ	固有人他
すずかうたこ	鈴鹿詩子	固有人他
うしみいちご	宇志海いちご	固有人他
いえながむぎ	家長むぎ	固有人他
ゆうひりり	夕陽リリ	固有人他
もののべありす	物述有栖	固有人他
ふみのたまき	文野環	固有人他
ふしみがく	伏見ガク	固有人他
ぎるざれんさんせい	ギルザレンIII世	固有人他
けんもちとうや	剣持刀也	固有人他
もりなかかざき	森中花咲	固有人他
けんもちりきや	剣持力也	固有人他
かなえ	叶	固有人他
あかばねようこ	赤羽葉子	固有人他
ささきさく	笹木咲	固有人他
ほんまひまわり	本間ひまわり	固有人他
まかいのりりむ	魔界ノりりむ	固有人他
くずは	葛葉	固有人他
しいなゆいか	椎名唯華	固有人他
やみよのもるる	闇夜乃モルル	固有人他
せつな	雪汝	固有人他
くろはねくろと	黒羽黒兎	固有人他
かみなりぽあろ	神成ポアロ	固有人他
どーら	ドーラ	固有人他
とどろききょうこ	轟京子	固有人他
しすたーくれあ	シスター・クレア	固有人他
はなばたけちゃいか	花畑チャイカ	固有人他
やしろきずく	社築	固有人他
すずきまさる	鈴木勝	固有人他
りゅーしぇん	緑仙	固有人他
うづきこう	卯月コウ	固有人他
うみやしゃのかみ	海夜叉神	固有人他
はっさくゆず	八朔ゆず	固有人他
なかおあずま	名伽尾アズマ	固有人他
いずもかすみ	出雲霞	固有人他
あづちもも	安土桃	固有人他
あずちもも	安土桃	固有人他
うずきこう	卯月コウ	固有人他
しっこくのほしょくしゃ	漆黒の捕食者	固有人他
だーくねすいーたー	【DarknessEater】	固有人他
るこ	Ruco	固有人他
よみなみさくや	黄泉波咲夜	固有人他
すずきゆうり	鈴木遥理	固有人他
かんだしょういち	神田笑一	固有人他
あすかひな	飛鳥ひな	固有人他
はるさきえある	春崎エアル	固有人他
あめもりさよ	雨森小夜	固有人他
たかみやりおん	鷹宮リオン	固有人他
まいもとけいすけ	舞元啓介	固有人他
りんどうみこと	竜胆尊	固有人他
でびでびでびる	でびでび・でびる	固有人他
さくらりつき	桜凛月	固有人他
まちたちま	町田ちま	固有人他
じょーりきいち	ジョー・力一	固有人他
なるせなる	成瀬鳴	固有人他
べるもんどばんでらす	ベルモンド・バンデラス	固有人他
やぐるまりね	矢車りね	固有人他
ゆめおいかける	夢追翔	固有人他
くろいしば	黒井しば	固有人他
はなぶせしほ	花伏しほ	固有人他
あまもりさよ	雨森小夜	固有人他
まちだちま	町田ちま	固有人他
なるとこがね	鳴門こがね	固有人他
つきみしずく	月見しずく	固有人他
あちきたちなみ	遠北千南	固有人他
ぐんどうみれい	郡道美玲	固有人他
ゆづきろあ	夢月ロア	固有人他
おのまちはるか	小野町春香	固有人他
かたりべつむぐ	語部紡	固有人他
せとみやこ	瀬戸美夜子	固有人他
いぬいとこ	戌亥とこ	固有人他
あんじゅかとりーな	アンジュ・カトリーナ	固有人他
りぜへるえすた	リゼ・ヘルエスタ	固有人他
くどうちとせ	久遠千歳	固有人他
おとぎばらえら	御伽原江良	固有人他
わらべだめいじー	童田明治	固有人他
さえぐさあきな	三枝明那	固有人他
あいぞのまなみ	愛園愛美	固有人他
ゆきしろまひろ	雪城眞尋	固有人他
えくすあるびお	エクス・アルビオ	固有人他
れゔぃえりふぁ	レヴィ・エリファ	固有人他
はやままりん	葉山舞鈴	固有人他
にゅいそしえーる	ニュイ・ソシエール	固有人他
すずはらるる	鈴原るる	固有人他
はかせふゆき	葉加瀬冬雪	固有人他
かがみはやと	加賀美ハヤト	固有人他
よるみれな	夜見れな	固有人他
あるすあるまる	アルス・アルマル	固有人他
あいばういは	相羽ういは	固有人他
あまみやこころ	天宮こころ	固有人他
えりーこにふぁー	エリー・コニファー	固有人他
らとなぷてぃ	ラトナ・プティ	固有人他
はやせそう	早瀬走	固有人他
すこやかな	健屋花那	固有人他
しぇりんばーがんでぃ	シェリン・バーガンディ	固有人他
まゆずみかい	黛灰	固有人他
ふみ	フミ	固有人他
ほしかわさら	星川サラ	固有人他
やまがみかるた	山神カルタ	固有人他
えまおうがすと	えま★おうがすと	固有人他
るいすきゃみー	ルイス・キャミー	固有人他
まつかいまお	魔使マオ	固有人他
ふわみなと	不破湊	固有人他
しらゆきともえ	白雪巴	固有人他
ぐうぇるおすがーる	グウェル・オス・ガール	固有人他
ましろめめ	ましろ爻	固有人他
ならか	奈羅花	固有人他
くるすなつめ	来栖夏芽	固有人他
ふれんいーるすたりお	フレン・E・ルスタリオ	固有人他
いぶらひむ	イブラヒム	固有人他
めりっさきんれんか	メリッサ・キンレンカ	固有人他
ながおけい	長尾景	固有人他
げんづきとうじろう	弦月藤士郎	固有人他
かいだはる	甲斐田晴	固有人他
そらほしきらめ	空星きらめ	固有人他
きんぎょざかめいろ	金魚坂めいろ	固有人他
たずみりく	田角陸	固有人他
あさひなあかね	朝日南アカネ	固有人他
きたこうじひすい	北小路ヒスイ	固有人他
すおうさんご	周央サンゴ	固有人他
とうどうこはく	東堂コハク	固有人他
にしぞのちぐさ	西園チグサ	固有人他
ろーれんいろあす	ローレン・イロアス	固有人他
れおすゔぃんせんと	レオス・ヴィンセント	固有人他
おりばーえばんす	オリバー・エバンス	固有人他
れいんぱたーそん	レイン・パターソン	固有人他
あくしあくろーね	アクシア・クローネ	固有人他
あまがせむゆ	天ヶ瀬むゆ	固有人他
ぽんとねい	先斗寧	固有人他
うみせよつは	海妹四葉	固有人他
ひゃくまんてんばらさろめ	壱百満天原サロメ	固有人他
しきなぎあきら	四季凪アキラ	固有人他
わたらいひばり	渡会雲雀	固有人他
せらふだずるがーでん	セラフ・ダズルガーデン	固有人他
ふうらかなと	風楽奏斗	固有人他
みそのさとし	美園聡	固有人他
こしみずとおる	小清水透	固有人他
ししどうあかり	獅子堂あかり	固有人他
かぶらきろこ	鏑木ろこ	固有人他
いがらしりか	五十嵐梨花	固有人他
いしがみのぞみ	石神のぞみ	固有人他
そふぃあばれんたいん	ソフィア・ヴァレンタイン	固有人他
くらもちめると	倉持めると	固有人他
かぶらぎ	カブラギ	固有人他
あかぎうぇん	赤城ウェン	固有人他
うさみりと	宇佐美リト	固有人他
ひばちまな	緋八マナ	固有人他
さいきいってつ	佐伯イッテツ	固有人他
ほしるべしょう	星導ショウ	固有人他
むらくもかげつ	叢雲カゲツ	固有人他
こやなぎろう	小柳ロウ	固有人他
いなみらい	伊波ライ	固有人他
たちつてとと	立伝都々	固有人他
しおりはるり	栞葉るり	固有人他
みらんけすとれる	ミラン・ケストレル	固有人他
おにぶしちはや	鬼伏千隼	固有人他
きたみゆうせい	北見遊征	固有人他
かいせい	魁星	固有人他
さかきねす	榊ネス	固有人他
ゆーどりっく	ユードリック	固有人他
つきの	月ノ	固有人姓
みと	美兎	固有人名
ゆうき	勇気	固有人姓
しずか	静	固有人姓
りん	凛	固有人名
すずや	鈴谷	固有人姓
すずか	鈴鹿	固有人姓
うたこ	詩子	固有人名
うしみ	宇志海	固有人姓
いえなが	家長	固有人姓
ゆうひ	夕陽	固有人姓
もののべ	物述	固有人姓
ありす	有栖	固有人名
ふみの	文野	固有人姓
たまき	環	固有人名
けんもち	剣持	固有人姓
とうや	刀也	固有人名
りきや	力也	固有人名
もりなか	森中	固有人姓
かざき	​花咲	固有人名
ささき	笹木	固有人姓
さく	咲	固有人名
まかいの	魔界ノ	固有人姓
ゆいか	唯華	固有人名
やみよの	闇夜乃	固有人姓
くろはね	黒羽	固有人姓
くろと	黒兎	固有人名
かみなり	神成	固有人姓
やしろ	社	固有人姓
きずく	築	固有人名
なかお	名伽尾	固有人姓
しょういち	笑一	固有人名
あめもり	雨森	固有人姓
さよ	小夜	固有人名
たかみや	鷹宮	固有人姓
まいもと	舞元	固有人姓
けいすけ	啓介	固有人名
りつき	凛月	固有人名
まちた	町田	固有人姓
りきいち	力一	固有人名
あちきた	遠北	固有人姓
ちなみ	千南	固有人名
なる	鳴	固有人名
ゆめおい	夢追	固有人姓
かける	翔	固有人名
わらべだ	童田	固有人姓
めいじー	明治	固有人名
ぐんどう	郡道	固有人姓
みれい	美玲	固有人名
ゆづき	夢月	固有人姓
かたりべ	語部	固有人姓
つむぐ	紡	固有人名
みやこ	美夜子	固有人名
おとぎばら	御伽原	固有人姓
えら	江良	固有人名
くどう	久遠	固有人姓
あきな	明那	固有人名
あいぞの	愛園	固有人姓
まなみ	愛美	固有人名
まひろ	眞尋	固有人名
まりん	舞鈴	固有人名
ふゆき	冬雪	固有人名
よるみ	夜見	固有人姓
かい	灰	固有人名
あまみや	天宮	固有人姓
はやせ	早瀬	固有人姓
そう	走	固有人名
すこや	健屋	固有人姓
かな	花那	固有人名
まつかい	魔使	固有人姓
すおう	周央	固有人姓
うみせ	海妹	固有人姓
ひゃくまんてんばら	壱百満天原	固有人姓
ししどう	獅子堂	固有人姓
ひばち	緋八	固有人姓
ほしるべ	星導	固有人姓
てんかいつかさ	天開司	固有人他
ふぇありす	ふぇありす	固有人他
