!!ATOK_TANGO_TEXT_HEADER_1
じょにー	ジョニー	固有人他
うさちゃんせんせい	うさちゃん先生	固有人他
ごんざれす	ゴンザレス	固有人他
せばすぴよ	セバスピヨ	固有人他
ふらんけん	フラン犬	固有人他
はとみれな	鳩見れな	固有人他
ときんちゃん	ときんちゃん	固有人他
すとまっくん	すとまっくん	固有人他
ろと	ロト	固有人他
ういろう	うい郎	固有人他
りきはむちゃん	りきハムちゃん	固有人他
かめっくしゅくん	かめっくしゅくん	固有人他
うちないろきちろう	内名色吉郎	固有人他
ふわっちくるーらー	フワッチクルーラー	固有人他
しらいぽめ	白井ぽめ	固有人他
でびっち	でびっち	固有人他
ゆがみん	ゆがみん	固有人他
おうまこうこく	桜魔皇国	固有一般
せれいねじょがくいん	世怜音女学院	固有一般
りーばーすらいやーず	Lie:verse Liars	固有一般
らんふー	蘭阜	固有一般
